  #########   ######
  #.......#   #....#
#####.#########.##.############
#P..............##............#
#####.######.##################
  #.......#..#
  ###.#####..#
    #........#
    ##########