  #########   ######
  #.......#   #....#
#####.#########.##.############
#P..............##............#
#...............##............#
#..............###............#
#..............###............#
#####...###..##################
  #.......#..#
  ###.#####..#
    #........#
    ##########